+.................-*%@@@@@@@@@@@@@@@@@@@@@@@@@@@@@@@@@@@@@@@@@@@@@@@@@@@@@@@@@@@@@@@@@@@@@
=                    .=*@@@@@@@@@@@@@@@@@@@@@@@@@@@@@@@@@@@@@@@@@@@@@@@@@@@@@@@@@@@@@@@@@@
=                        :=#@@@@@@@@@@@@@@@@@@@@@@@@@@@@@@@@@@@@@@@@@@@@@@@@@@@@@@@@@@@@@@
=                            :=#@@@@@@@@@@@@@@@@@@@@@@@@@@@@@@@@@@@@@@@@@@@@@@@@@@@@@@@@@@
=                                .=*@@@@@@@@@@@@@@@@@@@@@@@@@@@@@@@@@@@@@@@@@@@@@@@@@@@@@@
=                                    .-+#@@@@@@@@@@@@@@@@@@@@@@@@@@@@@@@@@@@@@@@@@@@@@@@@@
=                                         :=*%@@@@@@@@@@@@@@@@@@@@@@@@@@@@@@@@@@@@@@@@@@@@
=                                              :+#@@@@@@@@@@@@@@@@@@@@@@@@@@@@@@@@@@@@@@@@
=                                                  .-+#@@@@@@@@@@@@@@@@@@@@@@@@@@@@@@@@@@@
=                                                       .-+#@@@@@@@@@@@@@@@@@@@@@@@@@@@@@@
=                                                            .:=*%@@@@@@@@@@@@@@@@@@@@@@@@
=                                                                  .-+*%@@@@@@@@@@@@@@@@@@
=                                                                        :-+#%@@@@@@@@@@@@
=                                                                              :-+#%@@@@@@
=           NIJIKA                                                                   :-+#@
=                                                                                        =
=              .                                                               @=        =
=             -@%-                                                             =@        =
=           ::+#%%=-                                                +#-         *#.      =
=          :@@@@@@@@=                                                .*%.        :=      =
=          *@@@@@@@@%#                                                 :                 =
=         .%@@@@@#+@@#                                      :***###+   .%##*******#******%
=         =@@@@@@@@@#.                        [?]                      *#  :=-  :---.   -#
=         +@@@@@@@@@@#                                                 #*  @**= -+@=. .#@@
=         #@@@@@@@@@@@                                                 @=  :+@+  .@:  ##-#
=        :@@@@@@@@@@@@-                    +@@@@%***                   @- .**=.   =   -  =
#-.      *@@@@@@@@@@@@+                   +@@@@@@@@@=                  %#==========-----:*
@@@@*=:    +@@@@@@@##*:                  .@@@@@@@@@@:              ++   ...::::::::----==#
@@@@@@@@#+-+@@@@@@@=                      @@@@@@@@*@-            =%=          :----::.   =
@@@@@@@@@@@@@@@@@@@-                     =@@@@@@@@@@#           =%      %=    @*---==+**#%
@@@@@@@@@@@@@@@@@@@+                     #@@@@@@@@@@@                   @-   .@:         =
@@@@@@@@@@@@@@@@@@@@@%*=.                #@@@@@@@@@@@                  :@:   -@          =
@@@@@@@@@@@@@@@@@@@@@@@@@@#+-            #@@@@@@@@@@*                  +%    =%          =
@@@@@@@@@@@@@@@@@@@@@@@@@@@@@@%*=:       +@@@@@@@@@@=                  :.    =%          =
@@@@@@@@@@@@@@@@@@@@@@@@@@@@@@@@@@@#+-   :-+@@@@@@#%+                        +%          =
@@@@@@@@@@@@@@@@@@@@@@@@@@@@@@@@@@@@@@@%*-.-@@@@@@-                          *#          =
@@@@@@@@@@@@@@@@@@@@@@@@@@@@@@@@@@@@@@@@@@@@@@@@@*                           *#:@#%*     =
@@@@@@@@@@@@@@@@@@@@@@@@@@@@@@@@@@@@@@@@@@@@@@@@@*:                DOOR      *#:##%=     =
@@@@@@@@@@@@@@@@@@@@@@@@@@@@@@@@@@@@@@@@@@@@@@@@@@@@#+-                      *#          =
@@@@@@@@@@@@@@@@@@@@@@@@@@@@@@@@@@@@@@@@@@@@@@@@@@@@@@@@%*=.                 *#          =
@@@@@@@@@@@@@@@@@@@@@@@@@@@@@@@@@@@@@@@@@@@@@@@@@@@@@@@@@@@@@#=:             *#          =
@@@@@@@@@@@@@@@@@@@@@@@@@@@@@@@@@@@@@@@@@@@@@@@@@@@@@@@@@@@@@@@@@#+-         *#          =
@@@@@@@@@@@@@@@@@@@@@@@@@@@@@@@@@@@@@@@@@@@@@@@@@@@@@@@@@@@@@@@@@@@@@%*-.    *#          =
@@@@@@@@@@@@@@@@@@@@@@@@@@@@@@@@@@@@@@@@@@@@@@@@@@@@@@@@@@@@@@@@@@@@@@@@@@#=:*%          =
@@@@@@@@@@@@@@@@@@@@@@@@@@@@@@@@@@@@@@@@@@@@@@@@@@@@@@@@@@@@@@@@@@@@@@@@@@@@@@@*=:.......+
