+........................................................................................+
=                                                                                        =
=                                                                                        =
=                                                                                        =
=          *+++++++++++++++++++++*-                        ==++++++++++++++++++*=        =
=         .@                     *=                        #=                  =*        =
=          @.                    %:                        @:                  -#        =
=          @.                    @.                        @.     DRAWER       -#        =
=          @.                    @.                       :@                   =#        =
=          @.                    @.                       :%                   *+        =
=          @.                    @.                       .#+++++++*%%*++++++++*:        =
=          @.                    %:                                 ..                   =
=          @.        BED         %-                                                      =
=          @.                    *+                                                      =
=          @.                    +*                                                      =
=          @.                    -#                                                      =
=          @.                    -#                                                      =
=          @.                    -#                                                      =
=          @.                    -#                                                      =
=          @.                    -#                                                      =
=          @*+++++===============*%.                                                     =
=                        ..........                                                      =
=                                                                                        =
=                                                                                        =
=                                                                                        =
=                                                                                        =
=                                                                                        =
=                                                                                        =
=                                                                                        =
=                                                                                        =
=                                                                                        =
=                                                                                        =
=                                                                                        =
=                                                                                        =
=                                                                                        =
=                                                                                        =
=                                                                                        =
=                                         CLOSET                                         =
=                                                                                        =
=                                                                                        =
=                                     .+=-     ==-                                       =
=                          .......    :#%=     +@+..::------:::::.                       =
=                     =#+++=========++++++++++++===---:::::::----*#                      =
=                     *+                                         =*                      =
+.....................@=.........................................+#......................+
