+.............................................................................-%#:.......+
=                                      :*.                .*                 .%=         =
=        .#.                         .*#:                :@-                :@-          =
=         =@:                       =%-                  @=                :@:           =
=          :#*.                     @-                  +%                :@-            =
=            :*%:                   =%                  @=                #-             =
=              =@                    ##                 -                                =
=               @=                   .+                                                  =
=               =-                                                                       =
=                                                                                        =
=                                                                                        =
=       :--==++++++++++************************#*#***#**********#**#****#****#******:    =
=      %#--::..........                                                            @=    =
=     .@-                                                                         :@:    =
=     -@                                                                          :@.    =
=     :@=                 .              -          ...     .===-.     :      .   :@.    =
= -**  @=       =++=.    :+**%@##*#-    .@%.       :@**%:   *%::-##    *#    +%.  :@.    =
=     .@:     -%=..-##:      .@:        *#-@:      =@  +%   +%   -@     ##.*#-     @-    =
=     .@:    .@:     -*      .@:       :@: -@:     +% .*%   =@**#@=      %@*       @=    =
=     -@     .@=-:           .@:      :@=   +%.    #%**@:   =%   %=      :@.       %=    =
=     =@      .--=%+         :@.      *%*****%*    @-  #*   +%   #*      :@.       #*    =
=     +#          *#         =@       @-     =@   .@:  -@   #%   *#      :@.       #*    =
=     *#         .@=         #*      -@       #*  .@:  .@:  =@   *#      +%        #*    =
=     *#    =#*+*%=          -.       .            *:   =.  -+   +#       .        #*    =
##-   *#        ..                                                                 #*    =
*.    *#                                                                           #*    =
=     *#                                                                           %+    =
=     *#                                                                           @=    =
=     #+                            Welcome to STARRY!                             @-    =
=     %=                                                                          :@.    =
=     %=                                                                          =@     =
=     %%*********##*#**##*************#***********#*##***************#*****#***#**#+     =
=                                                                                        =
=                                                                                  :-.   =
=              :                                                                   :-%*  =
=            -#*                       .                .-                            -%+*
=        .=##=.                       *#                .@:                             -%
=      -#*-                          +%                  -@:                             =
=     ==.                           -@.                   -@:                            =
=                                  :@:                     :%+                           =
=                                  %+                        #*                          =
=                                                             =.                         =
=                                                                                        =
=                                                                                        =
+........................................................................................+
